#route,truck name,truck type,capacity,initialLocation(x,y)
------------------------------------
DTTTTTTTTTTTTTTTTTTTTTTTTTTTTTTTTTT-
-T--------------R--R--------------T-
-TRRRRR--------VR--RRRRRR--------VT-
-T----R---------R--R----R---------T-
-T----R-I-------R--R----R-I-------T-
-T----RRRRR-----R--R----RRRRR-----T-
PT--------R----PR-PR--------R----PT-
ET--------R-----R-ER--------R-----T-
-T--------R--E--R--R--------R--E--T-
-TTTTTTTTTTTTTTTTTTTTTTTTTTTTTTTTTT-
--------R-----------------R-------R-
RRRRRRRRRRRRRRRRR-RRRRRRRRRRRRRRRRR-
-R--------------R--R--------------R-
-RRRRRR--------VR--RRRRRR--------VR-
-R----R---------R--R----R---------R-
-R----R-I-------R--R----R-I-------R-
-R----RRRRR-----R--R----RRRRR-----R-
PR--------R----PR-PR--------R----PR-
ER--------R-----R-ER--------R-----R-
-R--------R--E--R--R--------R--E--R-
-RRRRRRRRRRRRRRRR--RRRRRRRRRRRRRRRR-
------------------------------------
nQuim
c20
i1,1
tV
/
------------------------------------
DTTTTTTTTTTTTTTTTTTTTTTTTTTTTTTTTTT-
-T--------------R--R--------------T-
-TTTTTT--------VR--TTTTTT--------VT-
-R----T---------R--T----T---------T-
-R----T-I-------R--T----T-I-------T-
-R----TTTTT-----R--T----TTTTT-----T-
PR--------T----PR-PT--------T----PT-
ER--------T-----R-ET--------T-----T-
-R--------T--E--R--T--------T--E--T-
-RRRRRRRRRTTTTTTTTTTRRRRRRRRTTTTTTT-
--------R-----------------R-------R-
RRRRRRRRRRRRRRRRR-RRRRRRRRRRRRRRRRR-
-R--------------R--R--------------R-
-RRRRRR--------VR--RRRRRR--------VR-
-R----R---------R--R----R---------R-
-R----R-I-------R--R----R-I-------R-
-R----RRRRR-----R--R----RRRRR-----R-
PR--------R----PR-PR--------R----PR-
ER--------R-----R-ER--------R-----R-
-R--------R--E--R--R--------R--E--R-
-RRRRRRRRRRRRRRRR--RRRRRRRRRRRRRRRR-
------------------------------------
nZé
c10
i34,1
tP
/
