#route,truck name,truck type,capacity,initialLocation(x,y)
------------------------------------
DRRRRRRRRRRRRRRRRRRRRRRRRRRRRRRRRRR-
-R--------------R--R--------------R-
-RRRRRR--------VT--RRRRRR--------VT-
-R----R---------R--R----R---------R-
-R----R-I-------R--R----R-I-------R-
-R----RRRRR-----R--R----RRRRR-----R-
PR--------R----PR-PR--------R----PR-
ER--------R-----R-ER--------R-----R-
-R--------R--E--R--R--------R--E--R-
-RRRRRRRRRRRRRRRRRRRRRRRRRRRRRRRRRR-
--------R-----------------R-------R-
RRRRRRRRRRRRRRRRR-RRRRRRRRRRRRRRRRR-
-R--------------R--R--------------R-
-RRRRRR--------VR--RRRRRR--------VR-
-R----R---------R--R----R---------R-
-R----R-I-------R--R----R-I-------R-
-R----RRRRR-----R--R----RRRRR-----R-
PR--------R----PR-PR--------R----PR-
ER--------R-----R-ER--------R-----R-
-R--------R--E--R--R--------R--E--R-
-RRRRRRRRRRRRRRRR--RRRRRRRRRRRRRRRR-
------------------------------------
nQuim
c20
i1,1
tV
/
