#route,truck name,truck type,capacity,initialLocation(x,y)
------------------------------------
DRRRRRRRRRRRRRRRRRRRRRRRRRRRRRRRRRR-
-R--------------R--R--------------R-
-RRRRRR--------VT--RRRRRR--------VR-
-R----R---------R--R----R---------R-
-R----R-I-------R--R----R-I-------R-
-R----RRRRR-----R--R----RRRRR-----R-
PT--------R----PR-PR--------R----PR-
ET--------R-----R-ER--------R-----R-
-R--------R--E--R--R--------R--E--R-
-RRRRRRRRRRRRRRRRRRRRRRRRRRRRRRRRRR-
--------R-----------------R-------R-
RRRRRRRRRRRRRRRRR-RRRRRRRRRRRRRRRRR-
-R--------------R--R--------------R-
-RRRRRR--------VR--RRRRRR--------VR-
-R----R---------R--R----R---------R-
-R----R-I-------R--R----R-I-------R-
-R----RRRRR-----R--R----RRRRR-----R-
PR--------R----PR-PR--------R----PR-
ER--------R-----R-ER--------R-----R-
-R--------R--E--R--R--------R--E--R-
-RRRRRRRRRRRRRRRR--RRRRRRRRRRRRRRRT-
------------------------------------
nQuim
c20
i1,1
tV
/
------------------------------------
DRRRRRRRRRRRRRRRRRRRRRRRRRRRRRRRRRR-
-R--------------R--R--------------R-
-RRRRRR--------VR--RRRRRR--------VR-
-R----R---------R--R----R---------R-
-R----R-I-------R--R----R-I-------R-
-R----RRRRR-----R--R----RRRRR-----R-
PR--------R----PR-PR--------R----PT-
ER--------R-----R-ER--------R-----R-
-R--------R--E--R--R--------R--E--R-
-RRRRRRRRRRRRRRRRRRRRRRRRRRRRRRRRRR-
--------R-----------------R-------R-
RRRRRRRRRRRRRRRRR-RRRRRRRRRRRRRRRRR-
-R--------------R--R--------------R-
-RRRRRR--------VR--RRRRRR--------VR-
-R----R---------R--R----R---------R-
-R----R-I-------R--R----R-I-------R-
-R----RRTRR-----R--R----RRRRR-----R-
PR--------R----PR-PR--------R----PR-
ER--------R-----R-ER--------R-----R-
-R--------R--E--R--R--------R--E--R-
-RRRRRRRRRRRRRRRR--RRRRRRRRRRRRRRRR-
------------------------------------
nZé
c10
i1,2
tP
/
------------------------------------
DRRRRRRRRRRRRRRRRRRRRRRRRRRRRRRRRRR-
-R--------------R--R--------------R-
-RRRRRR--------VR--RRRRRR--------VR-
-R----R---------R--R----R---------R-
-R----R-I-------R--R----R-I-------R-
-R----RRRRR-----R--R----RRRRR-----R-
PR--------R----PR-PR--------R----PR-
ER--------R-----R-ER--------R-----R-
-R--------R--E--R--R--------R--E--R-
-RRRRRRRRRRRRRRRRRRRRRRRRRRRRRRTRRR-
--------R-----------------R-------R-
RRRRRRRRRRRRRRRRR-RRRRRRRRRRRRRRRRR-
-R--------------R--R--------------R-
-TRRRRT--------VR--RRRRRR--------VR-
-R----R---------R--R----R---------R-
-R----R-I-------R--R----R-I-------R-
-R----RRRRR-----R--R----RRRRR-----R-
PR--------R----PR-PR--------R----PR-
ET--------R-----R-ET--------R-----R-
-R--------R--E--R--R--------R--E--R-
-RRRRRRRRRRRRRRRR--RRRRRRRRRRRRRRRR-
------------------------------------
nTó
c10
i1,2
tE
/
------------------------------------
DRRRRRRRRRRRRRRRRRRRRRRRRRRRRRRRRRR-
-R--------------R--R--------------R-
-RRRRRR--------VR--RRRRRR--------VR-
-R----R---------R--R----R---------R-
-R----R-I-------R--R----R-I-------R-
-R----RRRRR-----R--R----RRTRR-----R-
PR--------R----PR-PR--------R----PR-
ER--------R-----R-ER--------R-----R-
-R--------R--E--R--R--------R--E--R-
-RRRRRRRRRRRRRRRRRRRRRRRRRRRRRRRRRR-
--------R-----------------R-------R-
RRRRRRRRRRRRRRRRR-RRRRRRRRRRRRRRRRR-
-R--------------R--R--------------R-
-TRRRRT--------VR--RRRRRR--------VR-
-R----R---------R--R----R---------R-
-R----R-I-------R--R----R-I-------R-
-R----RRTRR-----R--R----RRTRR-----R-
PR--------R----PR-PR--------R----PR-
ER--------R-----R-ER--------R-----R-
-R--------R--E--R--R--------R--E--R-
-RRRRRRRRRRRRRRRR--RRRRRRRRRRRRRRRR-
------------------------------------
nNando
c10
i1,2
tI
/
------------------------------------
DTRRRRRRRRRRRRRRRRRRRRRRRRRRRRRRRRR-
-R--------------R--R--------------R-
-RRRRRR--------VR--RRRRRR--------VR-
-R----R---------R--R----R---------R-
-R----R-I-------R--R----R-I-------R-
-R----RRRRR-----R--R----RRRRR-----R-
PR--------R----PR-PR--------R----PR-
ER--------R-----R-ER--------R-----R-
-R--------R--E--R--R--------R--E--R-
-RRRRRRRRRRRRRRRRRRRRRRRRRRRRRRRRRR-
--------R-----------------R-------R-
RRRRRRRRRRRRRRRRR-RRRRRRRRRRRRRRRRR-
-R--------------R--R--------------R-
-RRRRRR--------VR--RRRRRR--------VR-
-R----R---------R--R----R---------R-
-R----R-I-------R--R----R-I-------R-
-R----RRRRR-----R--R----RRRRR-----R-
PR--------R----PR-PR--------R----PR-
ER--------R-----R-ER--------R-----R-
-R--------R--E--R--R--------R--E--R-
-RRRRRRRRRRRRRRRR--RRRRRRRRRRRRRRRR-
------------------------------------
nChico-esperto
c10
i12,12
tI
/